######################################
##                          ##      ##
######  ##############  ##  ##  ######
##      ##  ##          ##  ##      ##
##  ######  ##        ####  ######  ##
##                                  ##
##                                  ##
##              #######             ##
##              #     #             ##
##      s       #  e  #             ##
##              #     #             ##
##              #######             ##
##                                  ##
##                                  ##
##  ######  ##  ##  ######  ##  ##  ##
##      ##  ##  ##  ##      ##  ##  ##
##  ##  ##  ##  ######  ######  ##  ##
##  ##      ##              ##      ##
######################################
