##s ##################################
##  ##          ##              ##  ##
##  ######  ##  ##  ##########  ##  ##
##      ##  ##      ##      ##  ##  ##
######  ##  ##########  ##  ##  ##  ##
##  ##      ##      ##  ##  ##      ##
##  ##########  ##  ##  ##  ######  ##
##          ##  ##      ##      ##  ##
##  ##  ##  ##  ##############  ##  ##
##  ##  ##  ##          ##      ##  ##
######  ##  ##  ##########  ##  ##  ##
##      ##  ##  ##          ##  ##  ##
##  ######  ##  ##  ######  ######  ##
##      ##  ##  ##  ##      ##      ##
######  ##  ##  ##  ##########  ######
##      ##  ##  ##          ##  ##  ##
##  ##########  ##########  ##  ##  ##
##                      ##          ##
################################## e##
