##s ##################################
##  ##          ##              ##  ##
##  ######  ##  ##  ##########  ##  ##
##      ##  ##      ##      ##  ##  ##
######  ##  ####  ####  ##  ##  ##  ##
##  ##      ##      ##  ##  ##      ##
##  ##########  ##  ##  ##  ##########
##          ##  ##      ##      ##  ##
##  ##  ##  ##  ##############  ##  ##
##  ##  ##  ##          ##      ##  ##
######  ##  ##  ##########  ##  ##  ##
##      ##  ##  ##          ##  ##  ##
##  ######  ##  ##  ######  ######  ##
##      ##  ##  ##  ##      ##      ##
######  ##  ##  ##  ##########  ######
##      ##  ##  ##          ##  ##  ##
##  ##########  ##########  ##  ##  ##
##                      ##          ##
################################## e##
